<b>Basic Vocabulary</b><br><br>

yes - aio <br>
no - non <br>
hello - ave <br>
bye - salve <br>
thanks - gratia <br><br>

of - ab <br>
and - et <br>

good - valus <br>
bad - malus <br><br>

clanner - frater <br>
magic - magus <br><br>

fight - ferio <br><br><br>



<b>Additional Vocabulary</b><br>
(optional plural for nouns: twist -ores/-res/-es/-s in the end of noun) <br><br>

<b>Ranks</b><br>
high officer/leader - proconsul <br>
officer - consul <br>
full member - compar <br>
probatory member - novus <br><br>



away! be off! - apage (imperative) <br>
body - corpus <br>
clanners - fratres <br>
dead - mortis <br>
fighter - ferius <br>
human - homin <br>
know - scio <br>
magic user - magi <br>
pale - albus <br>
stupid - fatuus/fex <br>
talk/speech - narro <br>
traitor - proditor <br>
sure - certe <br>
sword - gladius <br>
weapon (any) - telum <br> 
Will/choice - arbitratus ( "Hoowah arbitratus Shadowclan!" ) <br><br>

*cheer* - Hoowah! <br>
*lol* - har <br>
lag - mud <br>
ld - faint <br><br>


<b>Specific weapons </b><br><br>

Sword: Blam <br>
2h Sword: Stavon <br><br>

Axe: Cleven <br>
2h Axe: Retch <br><br>

Mace: Masson <br>
2h Mace: Hamp <br><br>

Lance: Kronk <br>
Pike: Punnel <br><br>

Dagger: Jab <br><br><br>



<b>Language accent possibilities </b><br><br>

TH --> T/D/ZH/V <br><br>

( tis, dat, zhose, wiv... ) <br>


You are free to develop your vocal expression further.
